('afstand', 'arustan')	[('n', 'nd')]
('aftale', 'arvtale')	[None]
('akkurat', 'accurat')	[None]
('akkurat', 'aguart')	[None]
('akkurat', 'agurat')	[None]
('akkurat', 'akurart')	[('ar', 'a'), ('k', 'kk')]
('akkurat', 'akurat')	[('k', 'kk')]
('akkurat', 'akuratte')	[('k', 'kk')]
('akkurat', 'arkurart')	[('ar', 'a'), ('k', 'kk')]
('akkurat', 'arkuret')	[('k', 'kk')]
('apparat', 'abarat')	[None]
('apparat', 'aberrant')	[None]
('apparat', 'apperat')	[None]
('automatisk', 'aftomatisk')	[('af', 'au')]
('automatisk', 'arutumatisk')	[None]
('benzin', 'bensin')	[('s', 'z')]
('bjerg', 'berg')	[('b', 'bj')]
('bjerg', 'bjav')	[('a', 'e'), ('a', 'er')]
('bjørn', 'bjoørn')	[None]
('bjørn', 'bjøen')	[('n', 'rn')]
('blank', 'black')	[('k', 'nk')]
('blank', 'blanke')	[None]
('blank', 'lang')	[('g', 'k'), ('n', 'nk')]
('blive', 'bli')	[None]
('blive', 'blie')	[None]
('brag', 'brau')	[('au', 'ag')]
('brag', 'brav')	[('av', 'ag')]
('brag', 'brave')	[('av', 'ag')]
('brevene', 'bravene')	[('ra', 're')]
('brylluppet', 'bryleoped')	[('l', 'll'), ('p', 'pp'), ('b', 'pp'), ('o', 'u')]
('brylluppet', 'brylerped')	[('l', 'll'), ('p', 'pp'), ('b', 'pp')]
('brylluppet', 'bryllopet')	[('p', 'pp'), ('o', 'u')]
('brylluppet', 'bryllup')	[('p', 'pp'), ('b', 'pp')]
('brylluppet', 'bryllupet')	[('p', 'pp')]
('brylluppet', 'bryluppet')	[('l', 'll')]
('brylluppet', 'frølåret')	[('l', 'll'), ('ø', 'y'), ('å', 'u')]
('camping', 'kamping')	[('k', 'c')]
('chance', 'chanse')	[('s', 'c')]
('chance', 'sjavse')	[('sj', 'ch'), ('s', 'c')]
('denne', 'den')	[('n', 'nn')]
('denne', 'dene')	[('n', 'nn')]
('design', 'defineret')	[('n', 'gn')]
('design', 'degsin')	[('g', 'gn'), ('n', 'gn'), ('eg', 'ig')]
('design', 'designet')	[None]
('design', 'desin')	[('n', 'gn')]
('dig', 'dag')	[('ag', 'ig')]
('diskussion', 'diskution')	[('tion', 'ssion')]
('drage', 'dreng')	[None]
('drejede', 'drage')	[('ag', 'ej')]
('dreng', 'drang')	[('ra', 're')]
('dreng', 'dreg')	[None]
('døgn', 'don')	[('n', 'gn'), ('o', 'ø')]
('døgn', 'døvn')	[('n', 'gn')]
('eftermiddag', 'eftermidag')	[('d', 'dd')]
('ekko', 'eko')	[('k', 'kk')]
('ekko', 'æko')	[('æ', 'e'), ('k', 'kk')]
('ekstra', 'ekstre')	[None]
('ekstra', 'extra')	[('x', 'ks')]
('ekstra', 'ægsdere')	[('g', 'k'), ('s', 'st'), ('d', 't'), ('s', 'ks')]
('engelsk', 'tysk')	[('s', 'ls'), ('sk', 'lsk')]
('enkelt', 'engkelt')	[('ng', 'n')]
('falsk', 'farlsk')	[None]
('filmene', 'filmen')	[None]
('fint', 'find')	[('d', 't')]
('fint', 'findt')	[('nd', 'n')]
('fjernede', 'fjerned')	[None]
('fjernet', 'fjerned')	[None]
('fjernet', 'fjernede')	[('ede', 'et')]
('fjernet', 'fjernt')	[None]
('fjernet', 'tilføjet')	[('e', 'er'), ('f', 'fj')]
('flytte', 'flydte')	[('dt', 'tt')]
('foregå', 'forgå')	[('for', 'fore')]
('foregå', 'forgår')	[('for', 'fore')]
('forhold', 'forbehold')	[None]
('forhold', 'forehold')	[('fore', 'for')]
('forhold', 'forhol')	[('l', 'ld')]
('forklarer', 'forklare')	[('re', 'rer')]
('fortjene', 'fortælle')	[('t', 'tj')]
('frem', 'fram')	[('ra', 're')]
('fremragende', 'ffremrevende')	[None]
('gavn', 'grauvn')	[('au', 'av')]
('gevinst', 'gevindst')	[('nd', 'n')]
('glatte', 'glate')	[('t', 'tt')]
('glemme', 'gleme')	[('m', 'mm')]
('godt', 'got')	[('t', 'dt')]
('grund', 'begrånd')	[('å', 'u')]
('gående', 'gåne')	[('n', 'nd')]
('helt', 'heldt')	[('ld', 'l')]
('helt', 'helte')	[None]
('hjørne', 'bjørne')	[('j', 'hj')]
('holde', 'hold')	[None]
('hurra', 'hura')	[('r', 'rr')]
('hvis', 'vis')	[('v', 'hv')]
('højere', 'håjer')	[('å', 'ø'), ('er', 'ere')]
('højere', 'højer')	[('er', 'ere')]
('højere', 'højre')	[None]
('høre', 'høer')	[('er', 're')]
('høre', 'hører')	[('rer', 're')]
('høre', 'lave')	[None]
('ignorerer', 'ignorere')	[('re', 'rer')]
('ignorerer', 'ironer')	[('er', 'rer')]
('imponere', 'improvisere')	[None]
('imponere', 'impunere')	[None]
('imponere', 'indponeret')	[('in', 'im')]
('imponere', 'indpunder')	[('er', 're'), ('in', 'im'), ('er', 'ere')]
('imponere', 'inponer')	[('in', 'im'), ('er', 'ere')]
('imponere', 'inponere')	[('in', 'im')]
('irritere', 'iriterre')	[None]
('irritere', 'iroteger')	[('er', 're'), ('r', 'rr'), ('er', 'ere')]
('irritere', 'irretere')	[None]
('kampagne', 'campaing')	[('ng', 'gn')]
('kampagne', 'champagne')	[None]
('kampagne', 'kampainge')	[('ng', 'gn')]
('kampagne', 'kampandge')	[None]
('kampagne', 'kampange')	[('ng', 'gn')]
('kampagne', 'kampanije')	[None]
('kampagne', 'kampanje')	[('nj', 'gn')]
('kampagne', 'kampenge')	[('ng', 'gn')]
('klubben', 'klupen')	[('p', 'bb')]
('klubben', 'kluppen')	[('pp', 'bb')]
('konklusion', 'komfimasgon')	[('k', 'kl')]
('konklusion', 'konklution')	[('tion', 'sion')]
('korrekt', 'correct')	[('t', 'kt')]
('korrekt', 'forkert')	[('k', 'kt'), ('r', 'rr'), ('t', 'kt')]
('korrekt', 'korakt')	[('r', 'rr'), ('a', 'e')]
('korrekt', 'korekkt')	[('r', 'rr'), ('kk', 'k')]
('korrekt', 'korekt')	[('r', 'rr')]
('korrekt', 'korret')	[('t', 'kt')]
('korrekt', 'korrrekt')	[None]
('krig', 'kre')	[None]
('krig', 'kri')	[('i', 'ig')]
('kræve', 'kreve')	[('re', 'ræ')]
('kunst', 'konst')	[('o', 'u')]
('kunst', 'kundst')	[('nd', 'n')]
('kurs', 'kuers')	[None]
('kurs', 'kurse')	[None]
('kvart', 'kvat')	[('a', 'ar')]
('kvart', 'kvrat')	[('a', 'ar')]
('kører', 'kør')	[None]
('kører', 'køre')	[('re', 'rer')]
('lotto', 'iåto')	[('t', 'tt')]
('lotto', 'loto')	[('t', 'tt')]
('lyspunkt', 'lysepunkt')	[None]
('lyspunkt', 'mørktpunkt')	[None]
('læge', 'lere')	[None]
('læge', 'lære')	[('æ', 'æg')]
('læge', 'lærer')	[('æ', 'æg')]
('læge', 'ville')	[None]
('lærere', 'leger')	[('er', 're'), ('er', 'ere')]
('lærere', 'læger')	[('er', 're'), ('er', 'ere')]
('lærere', 'lære')	[None]
('lærere', 'lærer')	[('er', 'ere')]
('marts', 'mars')	[('s', 'ts')]
('marts', 'mats')	[('a', 'ar')]
('mennesker', 'menensker')	[('n', 'nn')]
('middag', 'meda')	[('d', 'dd'), ('a', 'ag'), ('e', 'i')]
('middag', 'medag')	[('d', 'dd'), ('e', 'i')]
('middag', 'metdag')	[('d', 'dd'), ('e', 'i'), ('t', 'dd')]
('middag', 'mida')	[('d', 'dd'), ('a', 'ag')]
('mission', 'mision')	[('sion', 'ssion')]
('motto', 'morto')	[('or', 'o'), ('t', 'tt')]
('motto', 'moto')	[('t', 'tt')]
('måtte', 'mote')	[('o', 'å'), ('t', 'tt')]
('måtte', 'må')	[None]
('måtte', 'mådte')	[('dt', 'tt')]
('mælk', 'melk')	[('e', 'æ')]
('navn', 'narn')	[('n', 'vn'), ('ar', 'a')]
('nogen', 'ingen')	[None]
('nogen', 'nogle')	[None]
('nærmer', 'nærmere')	[None]
('offentlige', 'ofelig')	[('f', 'ff')]
('offentlige', 'ofentlige')	[('f', 'ff')]
('offentlige', 'offenlige')	[('n', 'nt')]
('offentlige', 'offentlig')	[None]
('ordsprog', 'ord')	[None]
('ordsprog', 'ordspørg')	[('sp', 'spr')]
('passager', 'passagere')	[None]
('passager', 'passasgere')	[None]
('pause', 'parse')	[None]
('pause', 'passe')	[None]
('pause', 'prase')	[None]
('pege', 'peje')	[('ej', 'eg')]
('plads', 'plas')	[('s', 'ds')]
('plads', 'plras')	[('s', 'ds')]
('pludselig', 'pludselige')	[None]
('pludselig', 'pluselig')	[('s', 'ds')]
('point', 'poing')	[('ng', 'nt')]
('point', 'points')	[None]
('point', 'pølser')	[None]
('projekt', 'prosjegekt')	[None]
('prøve', 'prøver')	[None]
('psykisk', 'psygisk')	[('g', 'k')]
('psykisk', 'psysisk')	[None]
('psykisk', 'syges')	[('g', 'k'), ('s', 'ps'), ('s', 'sk')]
('psykisk', 'sygisk')	[('g', 'k'), ('s', 'ps')]
('psykisk', 'sykisk')	[('s', 'ps')]
('rapport', 'report')	[('p', 'pp')]
('rask', 'rast')	[('s', 'sk')]
('regn', 'meget')	[('g', 'gn')]
('regn', 'regne')	[None]
('regn', 'reng')	[('g', 'gn'), ('n', 'gn')]
('regn', 'sol')	[None]
('rude', 'rod')	[('o', 'u')]
('rude', 'rode')	[('o', 'u')]
('række', 'rakke')	[('ra', 'ræ')]
('række', 'ratte')	[('a', 'æ'), ('ra', 'ræ'), ('e', 'æ')]
('røg', 'røj')	[('øj', 'øg')]
('sagt', 'sagd')	[('d', 't')]
('sagt', 'sargt')	[('ar', 'a')]
('sagtens', 'sagsen')	[('n', 'ns'), ('g', 'gt'), ('s', 'ns')]
('sagtens', 'saktens')	[('k', 'g')]
('samarbejde', 'samearbejde')	[None]
('samarbejde', 'samerarbejde')	[None]
('samarbejde', 'sammabejde')	[('a', 'ar'), ('mm', 'm')]
('samarbejde', 'sammarbejde')	[('mm', 'm')]
('samarbejde', 'sammebejde')	[('a', 'ar')]
('samarbejde', 'sloges')	[None]
('scenen', 'senden')	[('s', 'sc'), ('nd', 'n')]
('selv', 'selge')	[('l', 'lv')]
('selvfølgelig', 'selføgelig')	[('l', 'lv')]
('selvfølgelig', 'selfølgelig')	[('l', 'lv')]
('selvfølgelig', 'selvføllige')	[None]
('show', 'pas')	[None]
('show', 'pasdererdårliglyd')	[('å', 'o')]
('show', 'slope')	[None]
('show', 'sony')	[None]
('sikre', 'sikkre')	[('kk', 'k')]
('silke', 'selke')	[('e', 'i')]
('silke', 'slikke')	[('l', 'lk'), ('k', 'lk')]
('skaffe', 'skafe')	[('f', 'ff')]
('skrevet', 'brand')	[None]
('skrevet', 'skrivet')	[None]
('skrive', 'skriv')	[None]
('skubbede', 'skubber')	[None]
('skubbede', 'skubede')	[('b', 'bb')]
('slags', 'slak')	[('k', 'g'), ('s', 'gs')]
('slags', 'slaks')	[('k', 'g')]
('slags', 'slarks')	[('k', 'g'), ('ar', 'a')]
('slette', 'sætte')	[('æ', 'e'), ('s', 'sl')]
('slut', 'stut')	[('s', 'sl')]
('smerte', 'smærte')	[('æ', 'e')]
('snart', 'snat')	[('a', 'ar')]
('snuppe', 'snubbe')	[('bb', 'pp')]
('snuppe', 'snåppe')	[('å', 'u')]
('solgt', 'købt')	[None]
('speciel', 'special')	[None]
('speciel', 'spichel')	[None]
('speciel', 'spishel')	[None]
('springer', 'pas')	[('a', 'i')]
('springer', 'sprager')	[('a', 'i'), ('e', 'i')]
('springer', 'spraner')	[('a', 'i'), ('n', 'ng')]
('spørg', 'sper')	[('r', 'rg')]
('spørg', 'spøger')	[('r', 'rg')]
('spørgsmål', 'spøgsmål')	[None]
('spørgsmål', 'spørgelsmål')	[None]
('spørgsmål', 'spørgesmål')	[None]
('stakkels', 'seje')	[('s', 'st'), ('s', 'ls')]
('stakkels', 'stakels')	[('k', 'kk')]
('stakkels', 'stakkelse')	[None]
('stakkels', 'starkels')	[('ar', 'a'), ('k', 'kk')]
('store', 'stor')	[None]
('stribe', 'pas')	[('p', 'b')]
('stribe', 'strebe')	[None]
('stribe', 'strepe')	[('p', 'b')]
('stribe', 'strippe')	[('pp', 'b')]
('stribe', 'støst')	[('st', 'str')]
('strække', 'sdrakke')	[('d', 't'), ('ra', 'ræ')]
('strække', 'strejke')	[('e', 'æ'), ('k', 'kk')]
('stærk', 'skærk')	[('s', 'st')]
('stærk', 'slap')	[('a', 'æ'), ('s', 'st')]
('stærk', 'stræk')	[('k', 'rk'), ('r', 'rk')]
('succes', 'cyske')	[('y', 'u')]
('succes', 'succese')	[None]
('succes', 'sucess')	[None]
('succes', 'sykse')	[('k', 'c'), ('y', 'u'), ('s', 'c')]
('svajede', 'svagede')	[('ag', 'aj')]
('svajede', 'svejede')	[('ej', 'aj')]
('svaret', 'med')	[None]
('svaret', 'sard')	[('s', 'sv')]
('svaret', 'svared')	[None]
('svaret', 'svarede')	[None]
('svensk', 'engelsk')	[('n', 'ns'), ('sk', 'nsk'), ('s', 'sv'), ('s', 'ns')]
('sygdomme', 'sydomme')	[('y', 'yg')]
('sygdomme', 'sygedome')	[('m', 'mm')]
('synge', 'se')	[None]
('synge', 'sygne')	[('n', 'ng')]
('søge', 'søe')	[('ø', 'øg')]
('søge', 'søje')	[('ø', 'øg')]
('takt', 'halen')	[None]
('tegner', 'har')	[('a', 'e'), ('ar', 'e')]
('tegner', 'tarner')	[('n', 'gn'), ('ar', 'e')]
('tegner', 'tenger')	[('g', 'gn'), ('n', 'gn')]
('tekst', 'test')	[('s', 'ks')]
('tekst', 'text')	[('x', 'ks')]
('tekst', 'tæsk')	[('k', 'ks'), ('æ', 'e'), ('s', 'ks')]
('tidligere', 'senere')	[None]
('tidligere', 'tideligere')	[None]
('tidligere', 'tidliger')	[('er', 'ere')]
('tidligere', '´tidligere')	[None]
('tilskuere', 'tilskuer')	[('er', 'ere')]
('tilskuere', 'tilskurer')	[('er', 're'), ('rer', 're'), ('er', 'ere')]
('tjener', 'har')	[None]
('tjener', 'tgener')	[('t', 'tj')]
('tog', 'to')	[('o', 'og')]
('tog', 'tong')	[('o', 'og')]
('tomt', 'themt')	[None]
('tradition', 'tradotion')	[None]
('travl', 'sløv')	[('v', 'vl'), ('l', 'vl')]
('travl', 'tralv')	[('v', 'vl'), ('l', 'vl')]
('travl', 'travel')	[('v', 'vl'), ('l', 'vl')]
('travl', 'travle')	[None]
('tryk', 'truk')	[None]
('tryk', 'tråk')	[None]
('trådte', 'tråde')	[('t', 'dt')]
('trådte', 'tråtte')	[('tt', 'dt')]
('træ', 'tæa')	[('t', 'tr')]
('tvivl', 'tvil')	[('l', 'vl')]
('tværs', 'tavs')	[('a', 'æ'), ('s', 'rs'), ('t', 'tv')]
('tværs', 'tvers')	[('e', 'æ')]
('tårer', 'sand')	[None]
('tårer', 'tor')	[None]
('tårer', 'tore')	[('re', 'rer')]
('tårer', 'tåre')	[('re', 'rer')]
('tårer', 'tårere')	[('re', 'rer')]
('tårer', 'tårre')	[('re', 'rer')]
('tænkt', 'tengt')	[('e', 'æ')]
('tænkt', 'tingt')	[None]
('uge', 'unge')	[('u', 'ug')]
('uge', 'uunge')	[('u', 'ug')]
('valg', 'vand')	[None]
('valg', 'varl')	[None]
('vej', 'varj')	[('ar', 'e')]
('vidste', 'hviste')	[('hv', 'v'), ('s', 'ds')]
('værst', 'varst')	[('a', 'æ')]
('øjne', 'øjenbryn')	[None]
('øjne', 'øjnen')	[None]
('ører', 'øer')	[('er', 'rer')]
('ører', 'øje')	[None]
('ører', 'øre')	[('re', 'rer')]